Daniel Day-Lewis	pope,pawn,gang_lord,oligarch,tyrant,despot,evil_genius	insurer,custodian,bailiff,general,appellant,functionary,chemist
Tina Fey	Catholic,liar,con_man,visitor,queen,victim,aristocrat	woman,portrayer,interviewee,tour_guide,screenwriter,broadcaster,guide
Abraham Lincoln	workmate,sibling,ex,renter,traveler,schoolmate,husband	star,groom,intern,jester,host,pupil,tour_guide
John Wilkes Booth	pope,theologian,consul,herald,follower,imitator,missionary	Catholic,star,lessee,predator,wimp,snake,dispatcher
Adam Sandler	patient,knight,believer,supporter,manager,employer,bishop	vet,manipulator,censor,representative,capitalist,senior,vocalist
Adam Smith	ombudsman,commoner,importer,peasant,subordinate,hotelier,native	Catholic,explorer,predator,wimp,snake,dove,evil_genius
Adam West	Catholic,liar,con_man,visitor,queen,victim,aristocrat	chief,client,chronicler,mother,professional,model,sinner
The Joker		
Al Bundy	candidate,con_man,visitor,colonist,demonstrator,judge,supporter	author,client,pupil,capitalist,mother,professional,model
Al Capone	pontiff,con_man,sage,commoner,savior,aristocrat,guest	crony,bank_robber,villain,handler,lawyer,cutthroat,thug
Eliot Ness	entertainer,mercenary,bodyguard,bouncer	
Al Gore	Catholic,infant,wizard,queen,housewife,tyrant,caregiver	wife,tour_guide,client,president,model,spouse,dove
Al Pacino	gatekeeper,coach,liar,aristocrat,manager,child,underwriter	confessor,masseur,demon,actress,jockey,novelist,vocalist
Alan Greenspan	devotee,criminal,wizard,babysitter,traitor,teenager,golfer	cleric,constable,litigator,mobster,incumbent,senior,substitute
Alan Sugar	liberal,patron,researcher,radical,advocate,double_agent,victim	content_provider,travel_agent,client,professional,model,peasant,role_model
Albert Einstein	nursemaid,confidante,spokesman,swain,tormentor,gaoler,dominatrix	star,brown_nose,atheist,saint,biographer,novelist,eyewitness
Alec Baldwin	vendor,candidate,doctor,employer,manager,teenager,supporter	convert,tour_guide,translator,speaker,adult,oracle,boyfriend
Alfred Hitchcock	candidate,doctor,sage,freedom_fighter,victim,deity,supporter	author,travel_agent,client,representative,mother,professional,model
Allan Quatermain	fashion_designer,con_man,visitor,queen,freedom_fighter,demonstrator,aristocrat	fighter,emissary,doctor,wife,chief,assassin,prostitute
Andrew Lloyd Webber	king,cleric,groom,infant,pastor,nun,lord	cop,demon,translator,pupil,renter,oracle,prostitute
Andy Warhol	gatekeeper,coach,devotee,aristocrat,manager,baby,golfer	nominee,bride,settler,gentleman,actress,colonizer,captive
Angelina Jolie	savior,monkey,predator,peasant,tyrant,fiend,groupie	goddess,fanatic,atheist,boxer,deity,troublemaker,hoodlum
Ann Coulter	gatekeeper,coach,devotee,doctor,aristocrat,underwriter,golfer	crony,medium,chess_player,atheist,banker,fashion_model,minister
Anna Karenina	infidel,emissary,lobbyist,valet,nun,proxy,friend	gang_member,groom,tour_guide,serf,columnist,pupil,guide
Emma Bovary	medium,godfather,beauty,character,woman,reader,baby	girl
Anthony Bourdain	advertiser,coach,con_man,visitor,actress,manager,terrorist	realtor,tour_guide,bailiff,chief,minister,capitalist,senior
Anton Chekov	mariner,hirer	
Antonio Vivaldi	terrorist,patient,outsider,thief,demonstrator,buyer,witness	fighter,target,waiter,regulator,client,star,hotelier
Archie Bunker	convert,civilian,hostage,colonist,slaveholder,convict,subordinate	customer,boy,target,groom,tour_guide,pupil,guide
Ariel Sharon	gatekeeper,vet,devotee,vassal,preacher,minion,golfer	nominee,candidate,imperialist,extremist,source,lover,model
Aristotle	performer,demon,thief,subscriber,speaker,baby,witness	artist,source,architect,mother,model,husband,anthropologist
Arnold Schwarzenegger	composer,knight,historian,villain,sponsor,tyrant,serial_killer	juvenile,respondent,drug_dealer,pastor,junior,sibling,dealer
Arthur Conan Doyle	duke,mutineer,knight,suitor,bull,lord,assassin	cartographer,manipulator,censor,interviewee,bride,sinner,satirist
Atticus Finch	detective,fashion_designer,coach,con_man,doctor,visitor,pastor	broadcaster,pupil,capitalist,mother,professional,senior,representative
Audrey Hepburn	bully,adolescent,actress,school_kid,master,fashion_model,footballer	ghost,convert,target,tour_guide,adult,oracle,guide
Aung San Suu Kyi	gatekeeper,coach,devotee,aristocrat,manager,baby,golfer	fighter,wife,tour_guide,mercenary,pupil,oracle,minister
Austin Powers	doctor,visitor,homeowner,underwriter,interpreter,supporter,operative	chief,client,pupil,capitalist,professional,model,rescuer
Ayn Rand	ambassador,theorist,spokesperson,advocate,sage,source,judge	terrorist,bully,atheist,translator,client,capitalist,mother
Babe Ruth	knave,luminary,bride,saint,deity,guide,witness	drug_dealer,pupil,mother,oracle,professional,model,representative
Barack Obama	ghost,king,con_man,hit_man,advertiser,mother,friend	lecturer,singer,assistant,writer,tour_guide,travel_agent,evaluator
Barry White	dad,singer,woman,father,source,fan	
Bart Simpson	hit_man,woman,con_man,father,celebrity,hunter,husband	manipulator,censor,detainee,professional,senior,warlord,vocalist
Basil Fawlty	Catholic,emissary,doctor,lobbyist,valet,sibling,proxy	client,pupil,mother,professional,senior,rescuer,representative
Bear Grylls		
Ben Affleck	fashion_designer,Catholic,liar,con_man,visitor,queen,mom	ghost,target,tour_guide,speaker,adult,oracle,guide
Benedict Arnold	paymaster,con_man,mediator,content_provider,parasite,staffer,tyrant	enemy,monster,heretic,socialist,quisling,mercenary,secularist
Benjamin Franklin	duke,hunter,predator,lion,criminal,groupie,pirate	columnist,photographer,dissident,broadcaster,novelist,sinner,satirist
Benny Hill	king,musician,star,wife,god,queen,jester	judge,player,girl,student
Bertie Wooster	con_man,candidate,visitor,leader,manager,photographer,supporter	wife,applicant,client,capitalist,mother,professional,senior
Bill Clinton	devotee,infant,waiter,dove,nanny,savior,groupie	advertiser,target,groom,intern,columnist,pupil,evil_genius
Bill Cosby	gang_lord,crime_boss,settler,wizard,nanny,lord,groupie	liberal,wife,tour_guide,actor,pupil,spouse,minister
Bill Gates	pope,radical,satrap,challenger,tyrant,despot,deity	storyteller,butcher,wholesaler,punter,borrower,girlfriend,inventor
Bill Murray	infant,dove,settler,believer,savior,lord,groupie	predator,pupil,oracle,nominator,apprentice,lady,representative
Billy Bob Thornton	hit_man,coach,slave_owner,father,manager,baby,celebrity	respondent,diner,groom,sibling,abolitionist,spouse,rescuer
Billy Crystal	gatekeeper,coach,aristocrat,manager,child,baby,golfer	jockey,stylist,demon,screenwriter,mariner,vocalist,apprentice
Bing Crosby	advertiser,terrorist,con_man,visitor,actress,coach,mom	ghost,cuckoo,god,bouncer,lion,puppet,prostitute
Bob Dylan	guest,rival,gentleman,car_dealer,sacred_cow,mother,dove	respondent,nominee,failure,captive,fashion_model,boyfriend,anthropologist
Leonard Cohen	coach,con_man,visitor,guitarist,manager,accompanist,buyer	constable,chief,pupil,capitalist,detainee,senior,warlord
Bob Marley	liar,pawn,outlaw,villain,chronicler,footballer,princess	exporter,monkey,double,predator,pupil,oracle,rescuer
Boba Fett	fashion_designer,voter,visitor,queen,character,aristocrat,interpreter	parasite,capitalist,mother,functionary,model,warlord,sinner
Bobby Fischer	coach,con_man,doctor,counsellor,sage,manager,judge	terrorist,liberal,nominee,chief,client,shareholder,president
Bono	patron,civilian,pollster,artist,freedom_fighter,tyrant,aristocrat	plastic_surgeon,pawn,helper,guitarist,storyteller,cheater,troublemaker
Brad Pitt	Catholic,infant,chess_player,traitor,tyrant,caregiver,defendant	goddess,medium,target,tour_guide,source,speaker,oracle
Brian Wilson	confessor,publicist,adept,dentist,accompanist,hooker,dove	manipulator,censor,colonizer,abbot,rescuer,nerd,flak
Bridget Jones	detective,cop,coach,con_man,doctor,visitor,homeowner	translator,infidel,builder,actress,nun,villain,friend
Britney Spears	bully,pope,pawn,heir,nanny,savior,groupie	vendor,reporter,gentleman,translator,captive,saint,anthropologist
Bruce Lee	ghost,rival,villain,tyrant,knight,bishop,serial_killer	passenger,exporter,star,iconoclast,abbot,rescuer,prosecutor
Bruce Springsteen	boy,guest,rival,gentleman,car_dealer,sacred_cow,dove	respondent,nominee,translator,captive,minister,boyfriend,anthropologist
Bruce Wayne	bully,adolescent,gang_member,actress,school_kid,master,footballer	fighter,wife,preacher,travel_agent,artisan,shaman,minister
Commissioner James Gordon	seducer,con_man,sage,commoner,aristocrat,tyrant,judge	translator,comedian,receptionist,student,speaker,satirist,sinner
Harvey Dent	advertiser,coach,con_man,visitor,actress,manager,accompanist	emissary,brown_nose,sucker,lobbyist,valet,proxy,martyr
Batman	seducer,sage,commoner,tyrant,aristocrat,deity,caregiver	impersonator,terrorist,target,visitor,failure,speaker,baby
Buck Rogers	Catholic,convert,liberal,demon,believer,tutor	
Buddha	cleric,doctor,sage,aristocrat,judge,deity,caregiver	student,author,atheist,client,capitalist,mother,professional
Buzz Aldrin	vendor,lender,source,demonstrator,criminal,marketer,hotelier	travel_agent,pupil,oracle,professional,senior,rescuer,minister
Buzz Lightyear		
Emperor Caligula		
Cameron Diaz	giant,liar,con_man,visitor,damsel,commoner,child	convert,target,goddess,tour_guide,speaker,oracle,pilot
Captain Ahab	Catholic,convert,demon,believer,liberal	
Cardinal Richelieu	baby,girl,musician,character,beauty	
Carl Lewis	candidate,writer,actress,manager,accompanist,teenager,citizen	woman,gang_member,terrorist,capitalist,criminal,warlord,marketer
Carl Sagan	liar,pope,knight,believer,chef,villain,surgeon	detective,cartographer,dictator,experimenter,navigator,mariner,inventor
Stephen Jay Gould	terrorist,gang_member,double_agent,authority,poacher,travel_agent,handler	woman,journalist
Carrie Bradshaw	caller,nationalist,artist,writer,historian,journalist,abolitionist	propagandist,mystery_writer,novelist,speechwriter,screenwriter,satirist
Enrico Caruso	advertiser,coach,con_man,visitor,actress,manager,accompanist	builder,applicant,travel_agent,client,mother,professional,model
Cary Grant	Catholic,infant,queen,sibling,traitor,tyrant,caregiver	realtor,evangelist,parliamentarian,bailiff,translator,chief,functionary
Giacomo Casanova	fashion_designer,con_man,visitor,queen,freedom_fighter,demonstrator,aristocrat	fighter,emissary,wife,doctor,villain,chief,assassin
Charlemagne	seducer,con_man,sage,commoner,tyrant,aristocrat,deity	wife,author,tour_guide,chef,client,professional,model
Charles Atlas	dad,witch_doctor,medium,doctor,spin_doctor,lady,evil_genius	gang_member,priest,mentor,model,instructor,role_model,leader
Charles Darwin	detective,advertiser,examiner,con_man,researcher,historian,double_agent	bowler,fighter,house_guest,initiate,adult,interviewer,pilot
Charles Dickens	advertiser,coach,con_man,visitor,believer,speaker,actress	enemy,patient,monster,tour_guide,soldier,shareholder,guide
Charles Foster Kane	fundamentalist,shipper,target,winner,bride,intruder,baby	exporter,star,groom,tour_guide,sibling,spouse,dealer
Charlie Brown	infant,doctor,winner,loser,wimp,legislator,victor	publisher,attorney,chess_player,decision_maker,caller,driver,player
Charlie Chaplin	wizard,heir,nanny,savior,nurse,groupie,adult	star,wife,pupil,fighter,spouse,rescuer,minister
Charlie Parker	hit_man,woman,con_man,artist,character,hunter,father	waiter,applicant,predator,guard,cheater,demonstrator,boyfriend
Che Guevara	Catholic,decision_maker,pimp,goon,car_dealer,oligarch,marketer	parasite,pupil,capitalist,mother,model,warlord,sinner
Christian Bale	con_man,expert,visitor,seller,manager,supporter,opponent	emissary,prostitute,companion,chief,prisoner,assassin,explorer
Christopher Columbus	advertiser,coach,con_man,visitor,actress,manager,accompanist	ghost,spy,foreigner,driver,mercenary,gang_member,conqueror
Christopher Hitchens	gatekeeper,theorist,coach,devotee,aristocrat,underwriter,golfer	atheist,advocate,journalist,novelist,opponent,commentator,editor
Chuck Norris	ghost,giant,rival,villain,tyrant,bishop,serial_killer	ombudsman,plastic_surgeon,chief,capitalist,shaman,senior,warlord
Cicero	fashion_designer,coach,con_man,colonist,manager,freedom_fighter,judge	travel_agent,pupil,oracle,professional,senior,rescuer,minister
Clark Gable	Catholic,liar,con_man,visitor,queen,victim,aristocrat	chief,client,chronicler,mother,professional,model,sinner
Clark Kent	gatekeeper,coach,devotee,aristocrat,manager,baby,golfer	insurgent,mediator,content_provider,guard,fashion_model,judge,informant
Cleopatra		
Clint Eastwood	composer,knight,believer,employer,mentor,tyrant,sponsor	adviser,atheist,client,banker,professional,president,model
Colin Farrell	enemy,athlete,authority,prodigy,source,witness,opponent	vet,wife,gang_member,chief,representative,mother,model
Colonel Sanders	seducer,con_man,sage,commoner,tyrant,aristocrat,deity	wife,author,tour_guide,chef,client,professional,model
Confucius	tyrant,parasite	
Copernicus	cartographer,star,stakeholder,sage,priest,navigator,mariner	chemist
Cosmo Kramer	outsider,expert,reporter,advocate,lobbyist,subscriber,minister	activist,bitch,teenager,babysitter,navigator,hoodlum,editor
Courtney Love	king,bully,role_model,heir,master,fashion_model,footballer	goddess,medium,winner,tour_guide,source,adult,oracle
Croesus	Catholic,jailer,respondent,accuser,trafficker,researcher,advocate	assailant,speaker,mystery_writer,abuser,torturer,defendant,opponent
Herodotus		
Daffy Duck	brown_nose,companion,bouncer,fugitive	
Dame Edna Everage		
Dan Brown	caller,nationalist,artist,writer,historian,journalist,abolitionist	propagandist,mystery_writer,novelist,speechwriter,screenwriter,satirist
Robert Langdon	ambassador,coach,con_man,doctor,visitor,counsellor,sage	tour_guide,chief,client,representative,mother,professional,senior
Dan Quayle	advertiser,con_man,ambassador,consul,doctor,manager,judge	expert,handler,player,hoodlum,shareholder,editor,minister
Daniel Craig	knight,sponsor,villain,mentor,tyrant,rival,serial_killer	wife,applicant,client,capitalist,mother,professional,senior
Daniel Boone	cop,tourist,visitor,settler,crooked_cop,foreigner,citizen	investor,architect,climber,pirate,farmer
Dante Alighieri	ambassador,coach,researcher,publicist,authority,preacher,critic	prophet,priest,chronicler,fashion_model,model,role_model,anthropologist
Darth Maul	terrorist,con_man,radical,villain,traitor,tyrant,thug	double,recruit,assailant,mother,professional,senior,inferior
Darth Vader		
Davy Crockett	cop,tourist,visitor,settler,crooked_cop,foreigner,citizen	investor,architect,climber,pirate,farmer
David Beckham	Catholic,explorer,pawn,knight,villain,surgeon,native	ghost,goddess,medium,adult,oracle,deity,pilot
David Blaine	helper,counsellor,sage,housewife,lender,freedom_fighter,farmer	wife,builder,applicant,travel_agent,client,mother,professional
David Bowie	infant,respondent,candidate,traitor,knave,deity,caregiver	singer,designer,star,promoter,companion,mother,president
David Byrne	advertiser,tourist,photographer,actress,accompanist,artisan,interpreter	vet,manipulator,censor,parasite,capitalist,mother,warlord
David Caruso	Catholic,liar,con_man,visitor,victim,aristocrat,supporter	beauty,constable,authority,mercenary,travel_agent,iconoclast,capitalist
David Hasselhoff	Catholic,liar,con_man,visitor,queen,victim,aristocrat	singer,wife,author,preacher,client,mother,professional
David Lee Roth	customer,knight,villain,believer,manager,mentor,composer	diplomat,exporter,fighter,parliamentarian,abbot,spouse,rescuer
David Letterman	terrorist,liberal,knight,believer,villain,tyrant,bishop	jockey,lessee,groom,bouncer,abolitionist,rescuer,teenager
David Lynch	advertiser,coach,con_man,visitor,manager,sitter,buyer	exporter,actress,shareholder,trainee,staffer,pilot,anthropologist
David Mamet	enemy,winner,underdog,advocate,employer,oppressor,supporter	evangelist,fighter,fanatic,tour_guide,pupil,oracle,disciple
Dean Martin	devotee,theorist,coach,slave_owner,father,manager,woman	giant,foreigner,bouncer,lion,lady,pirate,prostitute
Deepak Chopra	coach,pawn,visitor,consul,sage,manager,aristocrat	respondent,blogger,dancer,comedian,fashion_model,evaluator,role_model
Dexter Morgan	spy,gang_lord,traitor,oligarch,tyrant,car_salesman,rebel	supervisor,sibling,girlfriend,schoolmate,spouse,rescuer,chemist
Dian Fossey	detective,fashion_designer,coach,con_man,doctor,visitor,pastor	broadcaster,pupil,capitalist,mother,professional,senior,representative
Dick Cheney	monster,outlaw,bandit,attacker,poacher,intruder,bull	infidel,source,stakeholder,actress,failure,villain,native
Dolly Parton	knight,believer,employer,manager,tyrant,rival,supporter	guitarist,foreigner,bouncer,peasant,comedian,mystery_writer,vocalist
Don Vito Corleone	spokesman,vendor,seller,lender,swain,tormentor,gaoler	slave,explorer,colonizer,mercenary,travel_agent,priest,capitalist
Don King	gatekeeper,manipulator,rapper,accompanist,broadcaster,suitor,principal	house_guest,wife,author,tour_guide,pupil,professional,model
Donald Duck	advertiser,miracle_worker,visitor,authority,intern,sponsor,girl	gang_member,groom,tour_guide,serf,columnist,pupil,guide
Donald Trump	gatekeeper,vet,devotee,vassal,wizard,aristocrat,missionary	passenger,diplomat,groom,sibling,spouse,rescuer,dealer
Dorian Gray	hit_man,convert,con_man,beauty,proselyte,assistant,character	controller,dove,model
Doris Day	advertiser,coach,con_man,visitor,actress,manager,accompanist	travel_agent,client,dissenter,mother,professional,model,opponent
Dorothy Parker	coach,guest,doctor,visitor,consul,sage,judge	driver,dissident,client,comedian,receptionist,satirist,sinner
Dr. John Watson	hero,sitter,fan,mystery_writer,entertainer,president,comedian	colonizer,infidel,neoconservative,god,extremist,villain,rescuer
Professor James Moriarty	spy,enemy,miracle_worker,sage,critic,bard,victim	king,knight,outlaw,villain,conqueror,warlord,leader
Eddie Murphy	Catholic,liar,con_man,visitor,victim,aristocrat,supporter	woman,patient,character,serf,mercenary,reader,vendor
Eddie Van Halen	competitor,monster,parent,radical,snake,girl,husband	client,pupil,capitalist,detainee,professional,model,warlord
Eddy Merckx	advocate,underdog,nominee,winner,foreigner,demonstrator,supporter	miracle_worker,photographer,lover,driver,fan,bull,warlord
Edith Piaf	fashion_designer,con_man,visitor,guitarist,actress,propagandist,supporter	author,tour_guide,travel_agent,client,mother,professional,model
Edward Hopper	advertiser,coach,con_man,visitor,sage,actress,manager	applicant,feudatory,travel_agent,client,mother,professional,model
Elizabeth Taylor	infant,helper,housewife,babysitter,traitor,tyrant,caregiver	beau,musician,bride,dancer,professional,girl,lady
Elmer Fudd	executioner,spy,chess_player,pontiff,con_man,passenger,miracle_worker	detective,socialist,defendant,mother,torturer,daddy,husband
Elmore Leonard	advertiser,nationalist,caller,propagandist,abolitionist,speechwriter,satirist	builder,applicant,travel_agent,client,mother,professional,model
Elvis Presley	liar,bully,adolescent,dove,heir,general,footballer	advertiser,socialist,groom,jester,intern,columnist,oppressor
Emily Dickinson	impersonator,star,decision_maker,house_guest,demon,believer,lover	target,baby,traveler,senior,golfer,model,tourist
Eminem	Catholic,liar,con_man,visitor,queen,tyrant,aristocrat	ghost,singer,beauty,authority,player,dancer,girl
Emperor Constantine	Catholic,cleric,coach,liar,con_man,queen,seducer	politician,prophet,demon,player,rebel,abuser,friend
Ming The Merciless		
Emperor Palpatine	coach,supervisor,parent,censor,master,mistress,instructor	teacher
Erasmus	performer,wife,demon,thief,authority,buyer,witness	artist,reader,farmer,investor,teacher,legislator,satirist
Eric Clapton	theorist,confessor,decision_maker,publicist,scammer,accompanist,sitter	caller,groom,tour_guide,sibling,minister,mourner,dealer
Ernest Hemingway	con_man,character,father,sage,drug_dealer,invalid,supporter	house_guest,builder,applicant,travel_agent,representative,screenwriter,anthropologist
Errol Flynn	fashion_designer,Catholic,liar,con_man,visitor,queen,mom	terrorist,slave,emissary,companion,travel_agent,prisoner,assassin
Euclid		
Evel Knievel	performer,researcher,gangster,lion,girl,supporter,witness	jockey,wife,driver,regulator,soldier,controller,husband
Federico Fellini	doctor,sage,freedom_fighter,victim,deity,supporter,hotelier	voter,spokesperson,ruler,propagandist,judge,caregiver,speechwriter
Fidel Castro	stylist,fugitive,militant,comedian,rebel,dissenter,demonstrator	groom,colonist,slaveholder,subordinate,convict,persecutor,mastermind
Flash Gordon	liar,pope,doctor,visitor,winner,photographer,supporter	realtor,competitor,applicant,shareholder,incumbent,gynecologist,chemist
Florence Nightingale	con_man,doctor,visitor,sage,actress,manager,freedom_fighter	travel_agent,client,pupil,mother,oracle,professional,model
Forrest Gump	medium,godfather,beauty,character,woman,reader,girl	manipulator,slave,pawn,vassal,builder,architect,principal
Francis Bacon	fashion_designer,coach,con_man,doctor,colonist,freedom_fighter,tyrant	nationalist,caller,abolitionist,novelist,satirist,screenwriter,speechwriter
Francis Crick	detective,advertiser,theorist,con_man,doctor,father,manager	tour_guide,chief,client,representative,mother,professional,senior
Frank Capra	advertiser,coach,con_man,visitor,manager,accompanist,interpreter	choreographer,curator,actress,mother,professional,model,screenwriter
Frank Columbo	dad,singer,woman,father,source,fan	
Frank Gehry	competitor,patron,con_man,researcher,authority,player,witness	barrister,athlete,regulator,journalist,model,role_model,celebrity
Frank Lloyd Wright	devotee,theorist,voter,father,manager,child,golfer	custodian,luminary,bailiff,appellant,landlord,functionary,chemist
Frank Sinatra	infant,wizard,housewife,employer,babysitter,traitor,tyrant	medium,settler,mother,child,boyfriend,role_model,anthropologist
Frank Zappa	knight,rival,employer,tyrant,fashion_model,deity,role_model	manipulator,explorer,athlete,censor,depositor,experimenter,architect
Franz Liszt	spokesman,vendor,lender,swain,tormentor,gaoler,dominatrix	plastic_surgeon,pawn,helper,guitarist,jockey,troublemaker,cheater
Fred Astaire	advertiser,con_man,visitor,guitarist,actress,manager,accompanist	fighter,atheist,tour_guide,preacher,adult,president,prostitute
Fredo Corleone	guest,workmate,sibling,ex,renter,girlfriend,schoolmate	explorer,miracle_worker,colonizer,mercenary,conqueror,traveler,opponent
Garry Kasparov	dad,hit_man,con_man,assistant,slave_owner,father,husband	house_guest,applicant,tour_guide,chief,client,professional,model
Garry Trudeau	con_man,doctor,visitor,sage,actress,manager,freedom_fighter	travel_agent,client,pupil,mother,oracle,professional,model
Garth Brooks	Catholic,infant,respondent,queen,traitor,victim,groupie	cuckoo,mother,bouncer,lion,interpreter,professional,model
Gary Larson	seducer,con_man,sage,commoner,tyrant,aristocrat,deity	wife,author,tour_guide,chef,client,professional,model
Genghis Khan	liar,wizard,insider,importer,handler,nanny,crime_boss	ambassador,bowler,insurer,double,gangster,batter,golfer
George Bernard Shaw	source,demon,seller,dupe,player,propagandist,substitute	artist,mystery_writer,caller,journalist,speechwriter,screenwriter,satirist
George Clooney	devotee,infant,decision_maker,vassal,nanny,farmer,nurse	ghost,goddess,medium,winner,tour_guide,oracle,guide
George Costanza	lender,confidante,retailer,seller,spokesman,swain,editor	monster,rival,follower,backer,companion,host,peer
George Foreman	winner,underdog,advocate,foreigner,parasite,demonstrator,supporter	hit_man,apprentice,assistant,slave_owner,mariner,husband,widow
George Harrison	Catholic,infant,helper,killer,housewife,tyrant,caregiver	vet,manipulator,star,censor,source,oracle,model
George Orwell	advertiser,coach,con_man,visitor,believer,speaker,actress	detective,hero,god,socialist,interviewee,atheist,oppressor
George Soros	coach,con_man,visitor,counsellor,sage,priest,mom	terrorist,liberal,decision_maker,populist,despot,snob,boyfriend
George W. Bush	copycat,paedophile,newborn,appeaser,savior,snob,groupie	referee,luminary,bailiff,proposer,boxer,renter,eyewitness
George Washington	insurgent,colonist,predator,commoner,intruder,assassin,scoundrel	overlord,representative,wife,tour_guide,rebel,spouse,pupil
Gerard Manley Hopkins	pope,pawn,theologian,hijacker,wizard,satrap,worshiper	exporter,recruiter,pastor,subscriber,abbot,spouse,rescuer
Glenn Beck	terrorist,rival,backer,companion,foe,critic,peer	courtesan,guest,host,captor,tormentor,supporter,monster
Gloria Steinem	advertiser,ambassador,homeowner,propagandist,demonstrator,supporter,operative	translator,critic,comedian,student,speaker,satirist,sinner
Mikhail Gorbachev	hit_man,woman,pope,knight,celebrity,lord,native	fighter,wife,tour_guide,mercenary,pupil,oracle,minister
Gordon Ramsay	terrorist,patient,outsider,thief,demonstrator,buyer,witness	fighter,target,waiter,regulator,client,star,hotelier
Grace Kelly	king,bully,adolescent,general,master,fashion_model,footballer	artist,celebrity,wife,bride,lover,model,athlete
Greta Garbo	king,bully,adolescent,gang_member,heir,actress,general	master,school_kid,footballer,role_model,fashion_model
Groucho Marx	Catholic,giant,liar,pope,queen,victim,aristocrat	target,researcher,stakeholder,translator,failure,professional,model
Gwyneth Paltrow	infant,housewife,manager,babysitter,traitor,tyrant,caregiver	ghost,goddess,convert,speaker,adult,oracle,deity
H.P. Lovecraft	coach,doctor,visitor,consul,sage,manager,aristocrat	author,tour_guide,travel_agent,pupil,professional,model,minister
Han Solo	fashion_designer,con_man,father,character,invalid,drug_dealer,mom	explorer,double_agent,commander,travel_agent,prisoner,mariner,emissary
Jabba the Hutt	ambassador,pope,plenipotentiary,prophet,pastor,priest,savior	ruler,bishop,saint
Hannibal Lecter	fundamentalist,liar,con_man,passenger,character,demon,thief	witch_doctor,woman,doctor,medic,father,spin_doctor,husband
Harry Houdini	vendor,seller,spokesman,swain,tormentor,gaoler,dominatrix	tour_guide,travel_agent,pupil,mother,professional,senior,lady
Harry Potter	devotee,respondent,heir,sitter,nanny,groupie,climber	gatekeeper,goddess,parliamentarian,retailer,tour_guide,deity,aspirant
Lord Voldemort		
Albus Dumbledore	terrorist,patient,outsider,thief,demonstrator,buyer,witness	fighter,target,waiter,regulator,client,star,hotelier
Heath Ledger	dad,Catholic,infant,chess_player,doctor,manager,traitor	ghost,goddess,target,tour_guide,speaker,adult,oracle
Helen Keller	Catholic,jailer,judge,advocate,votary,freedom_fighter,oppressor	lecturer,singer,mouthpiece,evangelist,tour_guide,travel_agent,evaluator
Henry Ford	guest,workmate,sibling,ex,traveler,girlfriend,schoolmate	gatekeeper,terrorist,liberal,driver,bride,parliamentarian,aspirant
Henry James	Catholic,infant,winner,candidate,queen,manager,traitor	fighter,soldier,chief,speaker,student,oracle,disciple
Henry Kissinger	charioteer,liar,pope,knight,chef,villain,surgeon	wife,tour_guide,feudatory,mercenary,pupil,oracle,minister
Henry Miller	interviewee,abolitionist,propagandist,broadcaster,mentor,screenwriter,editor	terrorist,handler,gang_member,double_agent,authority,travel_agent,poacher
Hercule Poirot	lender,confidante,seller,spokesman,swain,editor,tormentor	blackmailer,designer,pollster,investigator,litigator,attacker,speechwriter
Hillary Clinton	fundamentalist,knight,settler,suspect,bull,hooker,martyr	exporter,atheist,totalitarian,butcher,oracle,junior,inferior
Homer	ambassador,competitor,spokesperson,advocate,school_kid,demonstrator,supporter	applicant,travel_agent,client,representative,mother,professional,model
Homer Simpson	liberal,con_man,visitor,demon,thief,school_kid,prisoner	celebrity,tour_guide,soldier,fashion_model,model,role_model,guide
Howard Hughes	detective,woman,radical,benefactor,depositor,experimenter,nurse	realtor,chief,shareholder,prisoner,senior,spouse,rescuer
Howard Stern	hit_man,chess_player,con_man,king,player,fan,friend	star,mediator,recruit,subscriber,lieutenant,politician,apprentice
Hugh Grant	expert,con_man,visitor,seller,insider,manager,buyer	ghost,convert,goddess,tour_guide,adult,oracle,guide
Hugh Hefner	devotee,vet,beginner,actress,listener,spotter,lady	designer,driver,translator,student,model,satirist,sinner
Hugh Jackman	Catholic,pope,winner,source,victim,aristocrat,supporter	vet,wife,gang_member,author,chief,mother,model
Hulk Hogan	ghost,rival,believer,employer,composer,knight,supporter	king,artist,bride,knave,model,dove,husband
Humphrey Bogart	Catholic,infant,con_man,visitor,queen,manager,groupie	fighter,explorer,author,colonizer,chief,chronicler,prostitute
Imelda Marcos	giant,pope,con_man,commoner,tyrant,aristocrat,deity	offender,crooked_cop,demon,translator,pupil,oracle,prostitute
Indiana Jones	giant,liar,pope,doctor,visitor,sage,supporter	chief,client,pupil,capitalist,subordinate,shaman,professional
Jack Bauer	executioner,spy,chess_player,pontiff,con_man,passenger,miracle_worker	hirer,apostle,companion,herald,saint,martyr,disciple
Jack Kerouac	ambassador,coach,researcher,publicist,believer,speaker,mentor	artist,settler,colonizer,bride,chief,husband,boyfriend
Jack Nicholson	devotee,hit_man,wizard,father,manager,baby,lord	liberator,miracle_worker,authority,mercenary,convict,mastermind,leader
Jack The Ripper	advertiser,doctor,visitor,manager,victim,judge,matador	slave,explorer,beauty,tour_guide,translator,oracle,vocalist
Jackie Chan	ambassador,coach,photographer,father,manager,supporter,character	manipulator,censor,constable,iconoclast,capitalist,warlord,vocalist
Jackson Pollock	advertiser,coach,con_man,visitor,actress,manager,accompanist	builder,applicant,travel_agent,client,mother,professional,model
James Bond	liar,bully,pope,reporter,slave_owner,chef,lawyer	ghost,goddess,winner,tour_guide,oracle,deity,guide
Auric Goldfinger	expert,reporter,butcher,employer,lender,player,criminal	king,target,landlord,underwriter,conqueror,model,role_model
Ernst Stavro Blofeld	attorney,coach,supervisor,blogger,luminary,retailer,medium	blackmailer,designer,author,investigator,litigator,attacker,speechwriter
Dr. Julius No	gang_lord,failure,boyfriend,ghost,lord	
Sir Hugo Drax	fashion_designer,con_man,visitor,queen,freedom_fighter,demonstrator,aristocrat	politician,patron,beauty,player,wife,bride,model
Le Chiffre	liberal,researcher,blogger,player,critic,victim,girl	soldier,swindler,priest,journalist,professional,model,minister
James Dean	giant,liar,winner,priest,lady,supporter,opponent	warlord,pastor,chief,pupil,capitalist,evaluator,scoundrel
James Franco	fashion_designer,Catholic,liar,con_man,visitor,queen,mom	terrorist,slave,emissary,companion,travel_agent,prisoner,assassin
James Joyce	ambassador,coach,researcher,sage,believer,speaker,mentor	publisher,spokesperson,prophet,priest,chronicler,judge,anthropologist
James T. Kirk	candidate,doctor,theologian,visitor,soldier,freedom_fighter,lady	fashion_model,controller,client,minister,farmer,professional,senior
Jamie Oliver	reporter,advocate,lobbyist,babysitter,bitch,activist,navigator	diner,waiter,butcher,guard,iconoclast,representative,model
Jane Austen	fashion_designer,advertiser,coach,con_man,visitor,actress,manager	driver,tour_guide,speaker,receptionist,sinner,scoundrel,satirist
Janis Joplin	Catholic,infant,chess_player,queen,traitor,tyrant,caregiver	builder,applicant,travel_agent,client,mother,professional,model
Jar Jar Binks	insider,journalist,friend,passenger	
Jason Bourne	spy,criminal,terrorist,saint,loyalist,troublemaker	
Jay Leno	customer,knight,villain,believer,manager,mentor,composer	star,wife,atheist,guitarist,tour_guide,fighter,satirist
Jay-Z Carter	diviner,pawn,pope,knight,challenger,hooker,navigator	infidel,outsider,bouncer,proposer,abolitionist,renter,substitute
JD Salinger		
Beyoncé		
Jeff Koons	impersonator,star,decision_maker,house_guest,demon,believer,lover	target,baby,traveler,senior,golfer,model,tourist
Jenna Jameson	queen,photographer,writer,father,housewife,tyrant,supporter	builder,constable,travel_agent,pupil,capitalist,shaman,warlord
Jeremy Clarkson	gatekeeper,devotee,vassal,slave_owner,wizard,baby,golfer	exporter,star,wife,pupil,fighter,spouse,rescuer
Piers Morgan		
Jerry Lee Lewis	pope,pawn,gang_lord,oligarch,tyrant,despot,evil_genius	insurer,custodian,bailiff,general,appellant,functionary,chemist
Jerry Lewis	devotee,coach,liar,pope,father,manager,baby	diplomat,supervisor,cleric,general,pupil,spouse,defendant
Jerry Seinfeld	fashion_designer,advertiser,con_man,visitor,guitarist,actress,accompanist	passenger,atheist,medic,tour_guide,president,prostitute,satirist
Jerry Springer	liar,queen,damsel,commoner,suitor,interpreter,prince	commissioner,supervisor,bailiff,chief,master,representative,prosecutor
Jesse Jackson	gatekeeper,coach,liar,devotee,aristocrat,underwriter,golfer	passenger,competitor,pupil,peer,patient,star,minister
Jim Jones	gatekeeper,vet,coach,manager,voter,underwriter,golfer	ghost,fighter,wife,tour_guide,mercenary,minister,bride
Jim Morrison	advertiser,con_man,visitor,consul,sage,sponsor,judge	builder,constable,controller,shaman,senior,evaluator,hotelier
Jimi Hendrix	car_dealer,stylist,spokesperson,photographer,invalid,listener,rival	respondent,nominee,colonizer,captive,model,boyfriend,anthropologist
Jimmy Cagney	con_man,candidate,visitor,leader,manager,photographer,supporter	wife,applicant,client,capitalist,mother,professional,senior
Jimmy Carter	fashion_designer,boy,rival,car_dealer,drug_dealer,sacred_cow,mom	realtor,singer,driver,travel_agent,client,student,evaluator
Jimmy Stewart	Catholic,infant,con_man,visitor,queen,manager,groupie	fighter,explorer,author,colonizer,chief,chronicler,prostitute
Joan Rivers	fashion_designer,con_man,visitor,guitarist,actress,propagandist,supporter	author,tour_guide,travel_agent,client,mother,professional,model
Joaquin Phoenix	Catholic,infant,con_man,doctor,visitor,queen,manager	gang_lord,travel_agent,sacred_cow,witch,admirer,lord,girl
Joe Biden		
Joe Louis	coach,liar,con_man,doctor,necromancer,colonist,judge	performer,beauty,wife,beast,speaker,student,instructor
Johann Sebastian Bach	coach,chess_player,patron,blogger,guitarist,foreigner,lawyer	star,client,comedian,lover,entertainer,model,husband
John Belushi	knight,sponsor,villain,mentor,tyrant,rival,serial_killer	star,author,stakeholder,translator,player,student,failure
John Dillinger	spy,forger,liar,con_man,trafficker,thief,victim	drug_dealer,swindler,poacher,abuser,torturer,adulterer,sinner
J. Edgar Hoover	advertiser,target,enemy,consul,driver,source,criminal	killer,wizard,queen,representative,mother,assassin,serial_killer
John Grisham	ambassador,coach,spokesperson,advocate,sage,source,judge	client,pupil,capitalist,detainee,professional,senior,warlord
John Keats	impersonator,star,decision_maker,house_guest,demon,believer,lover	target,baby,traveler,senior,golfer,model,tourist
John Lennon	tyrant,groupie,wizard,nanny,savior,dove,adult	spokesperson,storyteller,minister,interpreter,novelist,caregiver,commentator
John Maynard Keynes	attorney,coconspirator,celebrity,reporter,driver,litigator,supporter	mom,actor,general,speaker,suitor,teacher,witness
John McCain	outsider,expert,reporter,handler,shareholder,bitch,navigator	diplomat,assassin,wife,actor,entrepreneur,adult,daddy
John McEnroe	theologian,consul,believer,chef,iconoclast,lord,surgeon	blackmailer,jockey,pollster,litigator,attacker,manipulator,speechwriter
John Travolta	patient,knight,employer,sponsor,composer,supporter,editor	client,pupil,capitalist,detainee,professional,senior,warlord
John Wayne	infant,house_guest,slave_owner,companion,sibling,sacred_cow,adult	author,bull,failure,editor,fashion_model,model,source
Johnny Cash	hit_man,woman,liar,pope,wizard,father,backer	ghost,wife,guitarist,actor,entrepreneur,pupil,peer
Jon Stewart	dad,theorist,coach,assistant,accompanist,artisan,citizen	builder,applicant,companion,shareholder,pupil,mourner,spouse
Jonathan Swift	ambassador,coach,researcher,publicist,authority,preacher,critic	publisher,spokesperson,prophet,priest,chronicler,judge,anthropologist
Joseph Goebbels	advertiser,coach,doctor,visitor,tour_guide,homeowner,supporter	politician,prophet,killer,demon,player,abuser,friend
Joseph Stalin	Catholic,liar,con_man,manager,freedom_fighter,traitor,tyrant	fighter,mercenary,travel_agent,poacher,capitalist,professional,warlord
Judas Iscariot	vicar,confessor,pontiff,con_man,consul,monk,nun	enemy,heretic,socialist,quisling,mercenary,critic,secularist
Judge Judy Sheindlin		
Julia Child	advertiser,coach,con_man,visitor,actress,manager,accompanist	courtesan,diner,waiter,butcher,guard,captor,model
Julia Roberts	bully,adolescent,heir,actress,school_kid,master,footballer	ghost,boy,goddess,target,convert,adult,oracle
Justin Bieber		
Justin Timberlake	voter,queen,wizard,freedom_fighter,suitor,aristocrat,mutineer	medium,author,mother,winner,saint,child,manufacturer
Kim Kardashian		
Kanye West	terrorist,liberal,knight,villain,tyrant,rival,serial_killer	colonizer,respondent,settler,translator,captive,missionary,anthropologist
Karen Carpenter	gatekeeper,plastic_surgeon,helper,pawn,rapper,guitarist,storyteller	manipulator,cheater,broadcaster,suitor,jockey,troublemaker,principal
Karl Lagerfeld	chef,groom,guru,beginner,homeowner	
Karl Marx	spokesman,seller,lender,swain,tormentor,gaoler,dominatrix	diner,author,tour_guide,travel_agent,client,puppet,professional
Karl Rove	gatekeeper,coach,devotee,aristocrat,manager,underwriter,golfer	bowler,politician,con_man,seller,swindler,scammer,friend
Kate Moss	Catholic,infant,wizard,babysitter,traitor,farmer,caregiver	ghost,patron,beauty,wife,bride,pupil,model
Keith Moon	novelist,screenwriter,friend	
Keith Richards	hit_man,con_man,father,writer,character,invalid,citizen	ghost,guitarist,foreigner,bouncer,peasant,comedian,vocalist
Kevin Smith	outsider,reporter,advocate,lobbyist,activist,babysitter,teenager	star,publicist,storyteller,actor,dancer,composer,ruler
Kim Philby	detective,coach,con_man,doctor,visitor,homeowner,underwriter	target,expert,author,translator,mystery_writer,model,role_model
King Lear	advertiser,miracle_worker,visitor,authority,intern,sponsor,girl	gang_member,groom,tour_guide,serf,columnist,pupil,guide
Kobe Bryant	debtor,woman,hero,father,suspect,bomber,spymaster	insurgent,jockey,stylist,loser,extremist,foe,lady
Kurt Cobain	ambassador,coach,helper,photographer,listener,manager,supporter	guitarist,foreigner,bouncer,critic,speaker,student,vocalist
Kurt Vonnegut	caller,nationalist,artist,writer,historian,journalist,abolitionist	propagandist,mystery_writer,novelist,speechwriter,screenwriter,satirist
Lance Armstrong	tyrant,knight,villain,composer,marketer,substitute,victor	translator,artist,gentleman,colonizer,captive,lady,husband
Lara Croft	giant,liar,doctor,photographer,wizard,damsel,interpreter	ghost,goddess,target,tour_guide,adult,oracle,guide
Larry David	hit_man,giant,con_man,celebrity,fan,buyer,lady	vet,manipulator,censor,pupil,mother,oracle,vocalist
Larry Flynt	hero,con_man,doctor,sage,actor,commoner,aristocrat	exporter,competitor,builder,applicant,shareholder,student,speaker
Larry King	gatekeeper,coach,believer,aristocrat,manager,underwriter,golfer	singer,jockey,publicist,interviewee,demonstrator,screenwriter,casualty
Lee Harvey Oswald	terrorist,monster,foe,follower,admirer,tormentor,supporter	customer,lackey,mother,travel_agent,priest,traitor,child
Gordon Gekko	medium,target,brown_nose,tour_guide,source,host,guide	monster,client,master,fashion_model,model,role_model,teacher
Lee Marvin	con_man,expert,visitor,seller,manager,supporter,opponent	emissary,prostitute,companion,chief,prisoner,assassin,explorer
Leni Riefenstahl	enemy,prophet,killer,seller,dupe,source,propagandist	gatekeeper,parliamentarian,client,mother,professional,model,aspirant
Lenny Bruce	liberal,expert,con_man,god,writer,mystery_writer,nurse	customer,wife,prophet,celebrity,pupil,capitalist,evil_genius
Leo Tolstoy	caller,nationalist,artist,writer,historian,journalist,abolitionist	propagandist,mystery_writer,novelist,speechwriter,screenwriter,satirist
Lex Luthor	enemy,heretic,con_man,hit_man,outlaw,victim,pirate	designer,patron,double,athlete,believer,mentor,baby
Lindsay Lohan	king,candidate,actress,employer,lawyer,footballer,supporter	fashion_designer,blogger,winner,pupil,saint,nerd,boyfriend
Linus Torvalds	servant,settler,predator,lion,snake,demonstrator,mistress	cop,translator,failure,pupil,oracle,porter,prostitute
Lisa Simpson	passenger,juvenile,coach,beginner,infant,mystery_writer,student	double,recruit,assailant,mother,professional,senior,inferior
Lois Lane	theologian,publicist,interviewee,believer,comedian,interrogator,spymaster	fighter,wife,tour_guide,mercenary,pupil,oracle,minister
Lord Byron	patient,applicant,thief,pupil,demonstrator,wholesaler,witness	fighter,target,waiter,regulator,client,star,hotelier
Lou Reed	devotee,theorist,coach,slave_owner,father,manager,woman	ghost,exporter,fighter,mercenary,pupil,oracle,minister
Louis Armstrong	liar,pope,pawn,knight,queen,aristocrat,footballer	client,chief,broadcaster,fan,representative,capitalist,senior
Luciano Pavarotti	doctor,researcher,advocate,actress,lawyer,wife,peer	soldier,priest,comedian,mentor,mother,entertainer,bard
Ludwig Van Beethoven	con_man,doctor,visitor,sage,actress,manager,freedom_fighter	travel_agent,client,pupil,mother,oracle,professional,model
Luis Suarez	brown_nose,sucker,martyr,pursuer	
Luke Skywalker	fashion_designer,Catholic,infant,con_man,visitor,queen,mom	diplomat,emissary,crooked_cop,double_agent,commander,travel_agent,assassin
Niccolò Machiavelli		
Madonna	seducer,con_man,sage,commoner,tyrant,aristocrat,deity	wife,author,tour_guide,chef,client,professional,model
Mae West	woman,player,guard,dancer,girl,nurse,friend	customer,wife,celebrity,soldier,client,model,husband
Mahatma Gandhi	coach,liar,con_man,manager,freedom_fighter,demonstrator,buyer	ombudsman,constable,appeaser,professional,senior,rescuer,novelist
Norma Desmond	Catholic,liar,con_man,visitor,queen,victim,aristocrat	chief,client,chronicler,mother,professional,model,sinner
Mao Tse-tung		
Marcel Duchamp	lender,confidante,retailer,seller,spokesman,swain,editor	designer,monster,artist,socialist,source,reader,chemist
Marco Pierre White	wizard,recruit,butcher,bitch,footballer,nerd,nanny	appellant,examiner,recruiter,beneficiary,boxer,lender,chemist
Marco Polo	Catholic,liar,con_man,visitor,colonist,victim,aristocrat	realtor,renter,expert,builder,litigator,scammer,capitalist
Margaret Thatcher	gatekeeper,coach,devotee,aristocrat,manager,baby,golfer	infidel,actress,mercenary,villain,pupil,oracle,minister
Marge Simpson		
Mariah Carey	liar,bully,footballer,heir,master,fashion_model,role_model	medium,vendor,reporter,winner,tour_guide,pupil,saint
Marilyn Monroe	bully,adolescent,actress,school_kid,master,fashion_model,footballer	goddess,target,tour_guide,speaker,adult,oracle,guide
Mark Twain	Catholic,infant,queen,giant,traitor,tyrant,caregiver	detective,hero,explorer,god,socialist,mentor,oppressor
Marlene Dietrich	Catholic,liar,con_man,visitor,queen,victim,aristocrat	ghost,guitarist,foreigner,bouncer,peasant,mystery_writer,vocalist
Marlon Brando	knight,believer,employer,manager,tyrant,rival,supporter	wife,preacher,client,capitalist,mother,professional,model
Martha Stewart	expert,reporter,lobbyist,activist,shareholder,bitch,navigator	boy,juvenile,target,goddess,sibling,oracle,deity
Martin Luther King	kidnapper,votary,goon,evacuee,parasite,foe,persecutor	recruiter,luminary,beneficiary,boxer,banker,junior,chemist
Mata Hari	detective,cop,coach,con_man,doctor,homeowner,underwriter	competitor,beauty,athlete,player,speaker,model,friend
Matt Drudge	liar,pope,knight,villain,chef,lion,surgeon	nationalist,propagandist,abolitionist,novelist,speechwriter,screenwriter,satirist
Megan Fox		
Mel Brooks	Catholic,liar,stylist,pope,aristocrat,scoundrel,pirate	realtor,choreographer,applicant,curator,actress,senior,screenwriter
Mel Gibson	terrorist,liberal,knight,believer,villain,tyrant,bishop	medium,patient,choreographer,curator,actress,farmer,screenwriter
Meryl Streep	outsider,con_man,visitor,candidate,seller,manager,supporter	ghost,goddess,convert,tour_guide,adult,oracle,guide
Mad Max Rockatansky		
Michael Bay	advertiser,coach,con_man,visitor,actress,manager,accompanist	builder,applicant,travel_agent,client,mother,professional,model
Michael Corleone	detective,Catholic,coach,con_man,ambassador,consul,queen	client,pupil,capitalist,detainee,professional,senior,warlord
Michael Jackson	infant,predator,newborn,traitor,fiend,communist,groupie	recruiter,luminary,beneficiary,minister,spouse,junior,chemist
Michael Jordan	composer,knight,historian,employer,manager,tyrant,president	star,recruiter,luminary,banker,junior,chemist,manufacturer
Michael Moore	hit_man,decision_maker,reporter,father,fan,lawyer,nurse	monster,groom,captive,intern,bull,watchdog,speechwriter
Michael O'Leary	coach,doctor,visitor,consul,sage,manager,aristocrat	author,tour_guide,travel_agent,pupil,professional,model,minister
Michael Phelps	candidate,con_man,visitor,colonist,demonstrator,judge,supporter	star,brown_nose,pupil,capitalist,mother,professional,model
Michelangelo	giant,con_man,commoner,tyrant,aristocrat,deity,prince	beauty,prophet,witch,saint,mother,princess,friend
Michelle Obama	ghost,king,con_man,hit_man,advertiser,mother,friend	wife,applicant,driver,client,shareholder,model,spouse
Mick Jagger	content_provider,rival,slave_owner,winner,suspect,tyrant,knight	vet,manipulator,wife,censor,client,artisan,pupil
Mickey Mouse	hit_man,guest,con_man,writer,father,invalid,husband	fighter,rescuer,builder,constable,chief,detainee,warlord
Mike Tyson	liberator,coach,liar,con_man,researcher,necromancer,colonist	author,controller,double_agent,villain,tour_guide,travel_agent,guide
Miles Davis	fashion_designer,ambassador,coach,con_man,doctor,visitor,counsellor	passenger,foreigner,pupil,detainee,oracle,defendant,native
Miss Jane Marple	Catholic,infant,guest,con_man,doctor,visitor,queen	adviser,blackmailer,supervisor,author,diplomat,litigator,mystery_writer
Moses	dad,guest,servant,rapper,manager,accompanist,groupie	candidate,wife,colonist,tour_guide,speaker,editor,victim
Mother Teresa	infant,vegetarian,heir,goddess,believer,newborn,widow	bishop,acolyte,companion,nun,priest,president,disciple
Muhammad Ali	trainer,boy,hero,double_agent,believer,villain,sitter	goddess,respondent,target,gentleman,colonizer,captive,oracle
Benito Mussolini	hit_man,pope,father,commoner,aristocrat,baby,lord	ghost,fighter,tour_guide,mercenary,pupil,oracle,spouse
Adolf Hitler	predator,beast,soldier,villain,traitor,golfer,supporter	warlord,parasite,minister,capitalist,professional,model,mastermind
Napoleon Bonaparte	Catholic,convert,demon,believer,liberal	
Ned Flanders	enemy,bodyguard,tourist,house_guest,workmate,rival,sibling	guest,miracle_worker,witch,landlord,schoolmate,leader,husband
Neil Armstrong	detective,woman,radical,benefactor,depositor,iconoclast,dictator	fighter,invalid,adult,detainee,prisoner,pupil,sinner
Nelson Mandela	god,settler,predator,militant,rebel,assassin,intruder	liberal,champion,gang_member,advocate,subscriber,communist,supporter
Neville Chamberlain	ambassador,pope,plenipotentiary,prophet,pastor,priest,savior	ruler,bishop,saint
Newt Gingrich	attorney,coach,investigator,employer,lawyer,interpreter,marketer	lecturer,singer,assistant,tour_guide,actor,travel_agent,evaluator
Nigella Lawson	coach,doctor,visitor,consul,sage,manager,aristocrat	diner,waiter,butcher,guard,minister,professional,model
Nikola Tesla	Catholic,giant,liar,pope,queen,aristocrat,scoundrel	explorer,colonizer,travel_agent,peasant,capitalist,farmer,native
Noah	trainer,hero,spokesperson,photographer,retailer,sitter,demonstrator	nationalist,caller,abolitionist,novelist,satirist,screenwriter,speechwriter
Noam Chomsky	coach,consul,loser,broadcaster,traveler,climber,porter	medium,liberal,terrorist,school_kid,student,snob,boyfriend
Noël Coward	Catholic,liar,pope,queen,aristocrat,criminal,scoundrel	drug_dealer,client,mother,oracle,professional,model,marketer
Norman Rockwell	advertiser,coach,con_man,visitor,actress,manager,accompanist	builder,applicant,travel_agent,client,mother,professional,model
Nostradamus		
Obi-wan Kenobi	expert	
Mr. Miyagi		
Oprah Winfrey	Catholic,stylist,prophet,colonist,aristocrat,surgeon,criminal	medium,tour_guide,failure,mimic,model,role_model,guide
Orson Welles	infant,candidate,housewife,employer,babysitter,traitor,caregiver	ambassador,singer,house_guest,author,tour_guide,travel_agent,evaluator
Wilbur Wright	devotee,theorist,voter,father,manager,child,golfer	custodian,luminary,bailiff,appellant,landlord,functionary,chemist
Orville Wright	seducer,con_man,sage,commoner,tyrant,aristocrat,deity	wife,author,tour_guide,chef,client,professional,model
Oscar Wilde	con_man,doctor,visitor,sage,believer,speaker,mentor	target,expert,author,translator,mystery_writer,model,role_model
Ozzy Osbourne	helper,assistant,wizard,character,employer,demonstrator,lord	diviner,guard,freedom_fighter,witch,bard,groupie,evil_genius
P. T. Barnum		
Pablo Picasso	gatekeeper,vet,aristocrat,puppet,bull,underwriter,golfer	medium,star,wife,guitarist,failure,fashion_model,dealer
Pac Man	hit_man,shipper,reporter,celebrity,wizard,baby,nurse	attorney,lessee,historian,beneficiary,experimenter,borrower,evil_genius
Niccolò Paganini		
Pamela Anderson	customer,boy,performer,writer,lawyer,baby,defendant	goddess,medium,winner,tour_guide,oracle,guide,pilot
Paris Hilton	liar,patron,survivor,celebrity,composer,groupie,defendant	ghost,medium,tour_guide,source,speaker,oracle,guide
Patch Adams	competitor,patron,con_man,researcher,authority,player,witness	barrister,athlete,regulator,journalist,model,role_model,celebrity
Paul McCartney	devotee,theorist,decision_maker,publisher,slave_owner,car_dealer,vegetarian	boy,medium,tour_guide,source,oracle,guide,pilot
Perry Mason	detective,fashion_designer,coach,con_man,doctor,visitor,pastor	bureaucrat,punter,student,mother,professional,model,prostitute
Pete Sampras	underdog,winner,employer,source,teenager,oppressor,supporter	fighter,tour_guide,chief,client,student,president,professional
Peter Griffin	seducer,con_man,sage,commoner,tyrant,aristocrat,deity	wife,author,tour_guide,chef,client,professional,model
Peter Jackson	liar,pope,pawn,vegetarian,beginner,villain,monkey	attorney,respondent,content_provider,recruiter,boxer,banker,chemist
Brian Griffin	liar,bully,wizard,heir,commoner,bull,footballer	diner,policyholder,appellant,receptionist,borrower,mariner,rescuer
Peter Pan	giant,liar,pope,doctor,visitor,winner,photographer	convert,groom,target,wizard,tour_guide,serf,guide
Peter Parker	rival,killer,gentleman,invalid,newborn,sacred_cow,dove	demon,vocalist,scammer,comedian,admirer,entertainer,screenwriter
Plato	giant,candidate,character,actress,employer,traitor,supporter	cop,bodyguard,housekeeper,crooked_cop,demon,oracle,prostitute
Adrian Monk	parent,hit_man,medium,patient,monster,con_man,witch_doctor	ghost,chess_player,adolescent,teenager,mother,star,spin_doctor
Pontius Pilate	gang_lord,sacred_cow,witch,admirer,lord,girl	
Pope Benedict XVI		
Pope Francis	gatekeeper,debtor,minion,vassal,negotiator,aristocrat,missionary	slave,proposer,priest,renter,spiritualist,navigator,pirate
Quentin Tarantino	expert,reporter,lobbyist,activist,shareholder,bitch,navigator	trafficker,exporter,patient,insurer,guitarist,retailer,manufacturer
Ralph Nader	navigator,bride,dentist,artisan,mistress,hooker,apprentice	populist,secularist,despot,snob,emperor,scoundrel,journalist
Grigori Rasputin	executioner,spy,chess_player,pontiff,con_man,passenger,miracle_worker	detective,socialist,defendant,mother,torturer,daddy,husband
Ray Kroc	advertiser,coach,con_man,doctor,visitor,manager,wholesaler	realtor,mercenary,chief,priest,mother,senior,prostitute
Raymond Chandler	advertiser,nationalist,caller,propagandist,abolitionist,speechwriter,satirist	builder,applicant,travel_agent,client,mother,professional,model
Richard Branson	underdog,explorer,winner,employer,supporter,operative,inventor	realtor,offender,tour_guide,banker,senior,dealer,prostitute
Richard Dawkins	coach,visitor,consul,sage,aristocrat,manager,judge	hit_man,examiner,brown_nose,atheist,secularist,inspector,explorer
Richard Nixon	con_man,visitor,colonist,victim,buyer,scoundrel,defendant	rescuer,constable,litigator,chief,detainee,senior,warlord
Richie Rich	chef,groom,guru,beginner,homeowner	
Ricky Martin	Catholic,liar,con_man,queen,victim,aristocrat,supporter	ghost,patient,character,bouncer,serf,vendor,vocalist
Ridley Scott	advertiser,coach,con_man,doctor,visitor,guitarist,actress	applicant,travel_agent,client,pupil,mother,professional,senior
Ringo Starr	friend	
Robbie Williams	liberal,knight,employer,sponsor,tyrant,rival,serial_killer	builder,constable,chief,capitalist,shaman,professional,model
Robert De Niro	Catholic,liar,con_man,visitor,queen,victim,aristocrat	chief,client,chronicler,mother,professional,model,sinner
Robert Redford	ambassador,coach,sheriff,counsellor,seller,manager,principal	choreographer,curator,actress,staffer,trainee,screenwriter,anthropologist
Robin Hood	liar,con_man,visitor,damsel,mercenary,suitor,bull	boy,target,author,serf,intern,columnist,pupil
Robin Williams	giant,liar,monster,pope,beast,attacker,puppet	jockey,liberal,terrorist,vocalist,confessor,bishop,opponent
Robinson Crusoe	advertiser,miracle_worker,visitor,authority,intern,sponsor,girl	gang_member,groom,tour_guide,serf,columnist,pupil,guide
Rocky Balboa	liberator,coach,liar,con_man,necromancer,colonist,judge	beauty,iconoclast,mother,functionary,model,warlord,sinner
Roger Federer	bully,adolescent,heir,actress,school_kid,fashion_model,footballer	ghost,target,tour_guide,speaker,oracle,guide,pilot
Ron Weasley	outsider,expert,subscriber,player,hoodlum,bitch,navigator	infidel,actress,nun,villain,babysitter,activist,friend
Rudy Giuliani	con_man,artist,celebrity,character,invalid,sacred_cow,citizen	neoconservative,atheist,speaker,banker,student,professional,minister
Rupert Murdoch	duke,pawn,beauty,despot,pope,emperor,mistress	insurer,recruiter,luminary,boxer,banker,junior,chemist
Rush Limbaugh	rival,celebrity,invalid,newborn,sacred_cow,composer,peer	singer,tour_guide,client,biographer,professional,evaluator,screenwriter
Russell Crowe	infant,liar,con_man,visitor,queen,manager,chess_player	recruiter,dissident,drug_dealer,abuser,evaluator,dealer,prostitute
Salman Rushdie	nationalist,writer,believer,speaker,abolitionist,novelist,mentor	enemy,heretic,socialist,quisling,mercenary,secularist,bitch
Salvador Dali	gatekeeper,coach,chef,aristocrat,puppet,bull,underwriter	monster,player,socialist,artist,historian,source,chemist
Sam Spade	attorney,coach,supervisor,blogger,luminary,retailer,medium	blackmailer,designer,author,investigator,litigator,attacker,speechwriter
Philip Marlowe	passenger,spy,researcher,foreigner,double_agent,player,entrepreneur	adviser,blackmailer,designer,author,litigator,attacker,speechwriter
Samson	underdog,employer,source,teenager,oppressor,vendor,supporter	wife,guru,tour_guide,client,pupil,professional,model
Samuel Johnson	trainer,fashion_designer,coach,chess_player,believer,mentor,commentator	drug_dealer,columnist,professional,model,role_model,guide,sinner
Samuel Pepys	advertiser,chess_player,visitor,manager,demonstrator,judge,caregiver	patient,athlete,critic,farmer,nurse,witness,manufacturer
Santa Claus	boy,pawn,villain,fan,adult,baby,defendant	groom,intern,authority,jester,host,pupil,tour_guide
Sarah Palin	Catholic,giant,liar,doctor,queen,aristocrat,supporter	lecturer,evangelist,guru,travel_agent,comedian,mystery_writer,evaluator
Savonarola		
Scipio Africanus		
Sean Connery	Catholic,liar,con_man,visitor,queen,victim,aristocrat	chief,client,chronicler,mother,professional,model,sinner
Seth MacFarlane	applicant,advocate,authority,prodigy,dancer,editor,saint	teacher
Sherlock Holmes	hit_man,con_man,artist,writer,character,mom,citizen	king,luminary,driver,player,guard,saint,scoundrel
Shirley Temple	Catholic,liar,con_man,visitor,queen,victim,aristocrat	chief,client,chronicler,mother,professional,model,sinner
Sid Vicious	Catholic,infant,guest,con_man,visitor,queen,mom	jockey,pawn,guitarist,storyteller,plastic_surgeon,troublemaker,cheater
Sigmund Freud	candidate,visitor,writer,employer,source,manager,caregiver	witch_doctor,woman,doctor,medic,father,model,spin_doctor
Simon Cowell	Catholic,liar,knight,villain,surgeon,mistress,native	parliamentarian,nominee,publicist,foreigner,censor,boxer,demonstrator
Sheldon Cooper	chauffeur,diner,elector,salesperson,receptionist,wholesaler,dispatcher	insurer,spokesperson,custodian,luminary,bailiff,appellant,chemist
Leonard Hofstadter	ambassador,pope,publicist,bishop,saint,crime_boss,prince	publisher,spokesperson,prophet,advocate,chronicler,judge,anthropologist
Spongebob Squarepants		
Stan Lee	publisher,teacher,preacher,initiate,manager,lawyer,marketer	hirer,nominee,rapper,publicist,wholesaler,salesman,inventor
Squidward Tentacles	patient,monkey,beauty,wife,artist,player,bride	star,reader,baby,girl,lady,model,friend
Stephen Colbert	trainer,guru,civilian,interviewer,footballer,nerd,flak	applicant,litigator,chief,pupil,mourner,rescuer,minister
Stephen Hawking	detective,fashion_designer,coach,monster,doctor,socialist,pastor	broadcaster,pupil,capitalist,mother,professional,senior,representative
Mr. Krabs		
Steve Ballmer	nursemaid,retailer,spokesman,swain,tormentor,gaoler,dominatrix	ombudsman,constable,detainee,prisoner,evaluator,rescuer,senior
Steve Jobs	customer,knight,villain,believer,manager,mentor,composer	advertiser,attorney,beneficiary,shareholder,borrower,depositor,policyholder
Steve Martin	liar,pope,knight,sacred_cow,lion,surgeon,casualty	jockey,star,groom,actor,medium,pupil,fashion_model
Steven Spielberg	gatekeeper,coach,devotee,aristocrat,manager,baby,golfer	trafficker,singer,predator,chef,importer,wholesaler,pirate
Stewie Griffin	applicant,advocate,authority,prodigy,dancer,editor,saint	teacher
Sun Tzu	coach,visitor,consul,sage,actress,manager,judge	advertiser,examiner,brown_nose,atheist,content_provider,inspector,eyewitness
Svengali		
Sylvester Stallone	Catholic,liar,pope,doctor,queen,aristocrat,supporter	builder,applicant,travel_agent,client,mother,professional,senior
John Rambo	spy,guest,beauty,publisher,boy,wholesaler,lady	driver,school_kid,adult,baby,president,model,widow
Tarzan		
Theodore Roosevelt	con_man,writer,father,drug_dealer,sacred_cow,mom,citizen	constable,litigator,chief,pupil,professional,warlord,minister
Thomas Edison	lender,confidante,retailer,seller,spokesman,swain,editor	artist,athlete,promoter,client,architect,professional,builder
Thomas Pynchon	caller,nationalist,artist,writer,historian,journalist,abolitionist	propagandist,mystery_writer,novelist,speechwriter,screenwriter,satirist
Tiger Woods	gatekeeper,coach,devotee,aristocrat,manager,underwriter,golfer	singer,rapper,actress,comedian,bard,saint,evil_genius
Tina Turner	patient,knight,believer,employer,tyrant,rival,supporter	author,builder,drug_dealer,client,mother,professional,model
Tom Cruise	devotee,decision_maker,hit_man,celebrity,wizard,fan,lord	convert,manipulator,censor,goddess,oracle,deity,vocalist
Tom Hanks	liar,pope,knight,chef,surgeon,martyr,native	lodger,nominee,psychiatrist,boarder,groom,renter,mourner
Tom Jones	liar,pope,knight,villain,saint,mistress,martyr	insurgent,scoundrel,lieutenant,abbot,emperor,rescuer,underling
Tom Sawyer	performer,celebrity,writer,father,car_dealer,mentor,composer	knight,groom,jester,mercenary,pupil,oracle,minister
Tom Waits	con_man,father,writer,character,tour_guide,invalid,citizen	ghost,target,stakeholder,driver,bouncer,peasant,prostitute
Tony Blair	bully,pimp,knight,gangster,teenager,saint,pirate	infidel,nationalist,atheist,actress,villain,abolitionist,novelist
Huckleberry Finn	fashion_designer,performer,chess_player,con_man,gentleman,newborn,peer	client,mentor,mother,model,role_model,guide,husband
Tony Robbins	trainer,ambassador,coach,respondent,blogger,peer,climber	serf,travel_agent,columnist,mentor,entertainer,role_model,sponsor
Tony Soprano	detective,Catholic,coach,con_man,ambassador,consul,cheater	chief,pupil,capitalist,detainee,professional,senior,warlord
Tony Stark	detective,Catholic,coach,liar,con_man,visitor,queen	nationalist,caller,abolitionist,novelist,satirist,screenwriter,speechwriter
Tomás de Torquemada		
Leon Trotsky	ruler,fugitive,authority,freedom_fighter,activist,rebel,leader	victim,wife,custodian,applicant,shareholder,student,capitalist
Tony Montana	Catholic,convert,liberal,demon,believer,intern,cheater	cop,pimp,paedophile,mercenary,poacher,abuser,prostitute
Victor Meldrew		
Vincent Van Gogh	impersonator,star,decision_maker,house_guest,demon,believer,lover	target,baby,traveler,senior,golfer,model,tourist
Virginia Woolf	gatekeeper,vet,devotee,doctor,aristocrat,underwriter,golfer	medium,fashion_model,tour_guide,discussant,satirist,dealer,opponent
Vladimir Lenin	seducer,fugitive,dissident,militant,freedom_fighter,representative,dissenter	author,tour_guide,chef,client,minister,professional,model
Vladimir Putin	hit_man,woman,liar,hijacker,slave_owner,wizard,missionary	fundamentalist,blackmailer,headhunter,colonizer,borrower,wholesaler,friar
Voltaire	trainer,fashion_designer,attorney,coach,chess_player,con_man,luminary	king,athlete,dancer,mentor,mother,role_model,husband
Carl Von Clausewitz		
Walt Disney	infant,monkey,groupie,outlaw,savior,mistress,dove	trafficker,stylist,con_man,hit_man,boxer,wholesaler,girl
Walt Whitman	publisher,theorist,coach,publicist,believer,preacher,lawyer	fighter,wife,tour_guide,mercenary,pupil,oracle,minister
Walter White	seducer,con_man,sage,commoner,tyrant,aristocrat,deity	wife,author,tour_guide,chef,client,professional,model
Warren Buffett	gatekeeper,coach,devotee,aristocrat,manager,baby,golfer	evangelist,parliamentarian,nominee,foreigner,boxer,demonstrator,inventor
Wayne Gretzky	composer,rival,villain,tyrant,knight,bishop,serial_killer	cleric,wife,groom,sibling,spouse,rescuer,dealer
Wayne Rooney	fashion_designer,stylist,chef,iconoclast,traitor,communist,criminal	cleric,ruler,intern,promoter,entrepreneur,dentist,senior
Weird Al Yankovic		
Will Smith	Catholic,pope,queen,victim,aristocrat,surgeon,scoundrel	respondent,censor,settler,retailer,captive,gentleman,missionary
William Randolph Hearst	liberator,miracle_worker,content_provider,school_kid,representative,mom,judge	don,double,recruit,assailant,senior,teacher,inferior
William Shakespeare	Catholic,liar,pope,queen,aristocrat,criminal,scoundrel	publicist,preacher,critic,chronicler,anthropologist,chemist,mystery_writer
William Shatner	Catholic,pope,blogger,killer,source,aristocrat,criminal	singer,star,doctor,researcher,companion,mother,president
Willy Wonka	king,terrorist,chess_player,con_man,visitor,sage,child	realtor,bouncer,chief,representative,senior,rescuer,prostitute
Winston Churchill	gatekeeper,coach,devotee,aristocrat,manager,underwriter,golfer	terrorist,monster,atheist,socialist,foe,oppressor,tormentor
Wolfgang Amadeus Mozart	hit_man,woman,supervisor,con_man,slave_owner,foe,principal	singer,travel_agent,client,pupil,student,model,climber
Kenny G	trainer,boy,hero,decision_maker,double_agent,adult,entertainer	respondent,lessee,stakeholder,beneficiary,mother,spouse,defendant
Woody Allen	Catholic,con_man,pawn,doctor,visitor,queen,victim	singer,terrorist,ruler,storyteller,actor,minister,speechwriter
Woody Guthrie	hit_man,con_man,rival,character,invalid,car_dealer,mom	respondent,nominee,settler,colonizer,captive,chief,anthropologist
Wyatt Earp	hit_man,con_man,artist,celebrity,character,mom,citizen	spinster,hunter,mercenary,detainee,prisoner,fighter,interrogator
Yogi Berra	giant,queen,source,victim,deity,lady,prince	jockey,pawn,guitarist,storyteller,plastic_surgeon,troublemaker,cheater
Zsa Zsa Gabor	fashion_designer,passenger,performer,patron,radical,dictator,casualty	mentor,professional,model,assassin,role_model,defendant,rebel
Pinocchio	fashion_designer,performer,chess_player,con_man,gentleman,newborn,peer	client,mentor,mother,model,role_model,guide,husband
Yoda	minion,beast,demon,thrall,monster	
Saul Goodman	Catholic,liar,outlaw,queen,rapper,villain,native	supervisor,wife,tour_guide,actor,pupil,spouse,representative
Stanley Kowalski		
Blanche DuBois	patron,miracle_worker,character,sage,authority,sibling,mom	wife,celebrity,bride,lover,model,lady,husband
Ron Burgundy	bowler,candidate,native	
Rain Man	hit_man,shipper,reporter,celebrity,wizard,baby,nurse	attorney,lessee,historian,beneficiary,experimenter,borrower,evil_genius
Inspector Gadget	detective,cop,coach,con_man,doctor,visitor,homeowner	client,pupil,mourner,professional,model,rescuer,minister
Professor Hans Zarkov		
H.A.L. 9000		
Walter Mitty		
Xena	chaser,valet	
Inspector Clouseau	detective,cop,coach,con_man,doctor,visitor,homeowner	client,pupil,mourner,professional,model,rescuer,minister
Joey Tribbiani	Catholic,jailer,respondent,accuser,trafficker,researcher,advocate	assailant,speaker,mystery_writer,abuser,torturer,defendant,opponent
Chandler Bing	boy,medium,brown_nose,rival,sponsor,girl,editor	hijacker,secretary,bitch,guru
Monica Geller		
Ross Geller	guest,workmate,sibling,ex,schoolmate,traveler,husband	target,failure,controller,speaker,mother,mariner,chemist
Rachel Green	terrorist,patient,outsider,thief,demonstrator,buyer,witness	fighter,target,waiter,regulator,client,star,hotelier
Phoebe Buffay	goon,underdog,outsider,hotelier,loser	
Liz Lemon	lender,confidante,retailer,seller,spokesman,swain,editor	debtor,investigator,school_kid,mother,role_model,leader,defendant
Jack Donaghy	coach,supervisor,parent,censor,master,mistress,instructor	teacher
Tracy Jordan	ghost,guru,jester,colonizer,villain,chronicler,sinner	diner,gentleman,bouncer,appellant,captive,borrower,policyholder
Jenna Maroney	gatekeeper,manipulator,helper,pawn,guitarist,accompanist,principal	gang_member,recruit,double,mother,professional,senior,inferior
Kenneth Parcell 		
Mr. Spock		
Jesse Pinkman		
Gustavo Fring		
Don Draper	detective,voter,pollster,theologian,proposer,defendant,operative	client,pupil,capitalist,mother,professional,model,minister
Leroy Jethro Gibbs	deputy,predator,populist,rebel,tyrant,despot,aristocrat	passenger,jockey,diner,ruler,bouncer,handler,rescuer
Tony DiNozzo		
Timothy McGee	devotee,theorist,liar,pope,investigator,aristocrat,missionary	diplomat,groom,cleric,tour_guide,sibling,spouse,rescuer
Tyrion Lannister		
Cersei Lannister		
Jaime Lannister		
Eddard Stark	detective,Catholic,coach,liar,con_man,visitor,queen	nationalist,caller,abolitionist,novelist,satirist,screenwriter,speechwriter
Chewbacca		
C-3PO		
R2D2		
Marty McFly	liberal,researcher,blogger,player,critic,victim,girl	soldier,swindler,priest,journalist,professional,model,minister
Doc Emmett Brown	devotee,slave_owner,wizard,lobbyist,car_dealer,chef,marketer	fundamentalist,atheist,bailiff,extremist,appellant,novelist,lady
Biff Tannen	detective,cop,doctor,homeowner,victim,underwriter,defendant	builder,applicant,client,broadcaster,artisan,professional,model
George McFly	liberal,researcher,blogger,player,critic,victim,girl	soldier,swindler,priest,journalist,professional,model,minister
Dirty Harry Callahan	detective,passenger,sheriff,deputy,thief,player,inspector	outlaw,soldier,journalist,professional,model,husband,rebel
Sonny Crockett	cop,tourist,crooked_cop,foreigner,pirate,citizen,climber	killer,wizard,slave_owner,queen,father,assassin,serial_killer
Inspector Endeavour Morse	advertiser,vendor,slave_owner,character,listener,accompanist,mom	copycat,target,believer,subscriber,mistress,marketer,substitute
Rico Tubbs	gatekeeper,coach,devotee,aristocrat,manager,baby,golfer	fighter,wife,tour_guide,mercenary,pupil,oracle,minister
Jean-Luc Picard		
Commander Data	supervisor,target,seller,car_dealer,drug_dealer,manager,client	headhunter,blackmailer,colonizer,dentist,borrower,friar,gamekeeper
Edward Cullen	coach,consul,father,aristocrat,manager,baby,lord	headhunter,respondent,queen,appellant,captive,assassin,prosecutor
Alan Partridge	detective,courtesan,captor,suitor,guest	
Dr. Greg House	sage,predator,prodigy,travel_agent,mom,double_agent,footballer	insurer,recruiter,general,mimic,banker,junior,chemist
Edmund Blackadder		
Baldrick		
Lord Percy Percy	ambassador,theorist,spokesperson,advocate,sage,source,judge	don,assailant,pupil,student,mother,professional,senior
Lt. George Colthurst St Barleigh		
The Scarlet Pimpernel		
Leonardo Da Vinci	monster,socialist,source,manager,composer,reader,native	groom,tour_guide,travel_agent,pupil,mourner,professional,senior
Hamlet	hit_man,liar,con_man,Catholic,visitor,queen,victim	medium,general,client,editor,fashion_model,model,role_model
Polonius		
Ophelia	colonizer,failure,heretic	
Romeo Montague	impersonator,star,decision_maker,house_guest,demon,believer,lover	target,baby,traveler,senior,golfer,model,tourist
Juliet Capulet		
Adolf Eichmann	liar,servant,deceiver,loser,traitor,tyrant,pirate	bouncer,chief,pupil,capitalist,functionary,senior,warlord
Bruce Banner	colonist,candidate,winner,source,freedom_fighter,judge,operative	vet,designer,student,censor,manipulator,capitalist,vocalist
Frasier Crane	adviser,attorney,author,theologian,assistant,historian,tutor	spiritualist,mystery_writer,inventor
Niles Crane	confessor,monster,scammer,puppeteer,importer,sitter,assassin	trafficker,exporter,nationalist,handler,wholesaler,satirist,speechwriter
Freddy Krueger	bureaucrat,killer,liar,ruler,slave_owner,queen,father	devil,radical,beast,soldier,villain,terrorist,thug
Keyser Söze		
Daphne Moon	duke,saint,pawn,tyrant,despot,pope,godfather	respondent,borrower,plaintiff,hunter,beneficiary,victim,spouse
Moe Szyslak	forger,liar,patron,counsellor,chef,manager,dancer	waiter,gang_member,bouncer,cheater,mother,entertainer,porter
Barney Gumble		
Fred Flintstone	enemy,liar,queen,demon,victim,reader,buyer	star,athlete,soldier,peasant,journalist,mother,slave
Barney Rubble	outsider,expert,reporter,advocate,lobbyist,subscriber,minister	activist,bitch,teenager,babysitter,navigator,hoodlum,editor
Michael Myers	con_man,leader,freedom_fighter,tyrant,felon,bomber,supporter	ghost,wife,assailant,student,mother,model,warlord
Jason Voorhees	Catholic,liar,con_man,manager,freedom_fighter,traitor,tyrant	fighter,mercenary,travel_agent,poacher,capitalist,professional,warlord
Barney Stinson	hit_man,giant,con_man,celebrity,fan,buyer,lady	spinster,detainee,hunter,mercenary,mother,prisoner,fighter
Professor Charles Xavier	devotee,pope,con_man,visitor,sage,victim,prince	fighter,wife,doctor,chief,oracle,professional,model
Rocket Raccoon		
Groot		
Bugs Bunny	Catholic,pope,photographer,queen,visitor,aristocrat,scoundrel	parasite,client,capitalist,mother,shaman,model,sinner
Shrek	giant,liar,candidate,con_man,visitor,manager,tyrant	applicant,client,pupil,capitalist,mother,professional,model
Porky Pig		
Yosemite Sam		
Wile E. Coyote	con_man,doctor,visitor,leader,manager,bull,supporter	cartographer,underdog,author,tour_guide,travel_agent,pupil,oracle
George Smiley	fashion_designer,con_man,visitor,queen,freedom_fighter,demonstrator,aristocrat	fighter,emissary,doctor,wife,chief,assassin,prostitute
Captain America	detective,con_man,sheriff,father,freedom_fighter,felon,bomber	author,chief,client,chronicler,professional,model,sinner
Bilbo Baggins	Catholic,convert,demon,believer,liberal	
Frodo Baggins	Catholic,convert,liberal,con_man,deputy,demon,double_agent	applicant,believer,bride,travel_agent,peasant,capitalist,widow
Samwise Gamgee	Catholic,coach,con_man,ambassador,visitor,counsellor,doctor	chief,client,representative,mother,professional,model,rescuer
John McClane	executioner,spy,chess_player,pontiff,con_man,passenger,miracle_worker	detective,socialist,defendant,mother,torturer,daddy,husband
Optimus Prime	con_man,doctor,sage,commoner,tyrant,aristocrat,deity	builder,applicant,bouncer,translator,travel_agent,student,evaluator
Jack Sparrow	fashion_designer,con_man,visitor,queen,freedom_fighter,demonstrator,aristocrat	fighter,emissary,doctor,wife,chief,assassin,prostitute
Edward Scissorhands	liberal,researcher,blogger,player,critic,victim,girl	soldier,swindler,priest,journalist,professional,model,minister
Olive Oyl	sibling,brat	
Popeye	Catholic,insurgent,ombudsman,subordinate,salesman,car_salesman	
Pepé Le Pew	boyfriend	
Sideshow Bob	monster,votary,attacker,insider,abbess,nerd,boyfriend	trafficker,renter,dupe,colonizer,borrower,wholesaler,policyholder
John Merrick		
Ed Wood	duke,pope,knight,queen,suitor,mutineer,hooker	respondent,insurer,luminary,bureaucrat,bailiff,appellant,chemist
Maximus Decimus Meridius		
Gore Vidal	ambassador,coach,sage,believer,speaker,mentor,judge	storyteller,actor,librettist,composer,novelist,screenwriter,satirist
Truman Capote	winner,believer,loser,wimp,speaker,mentor,victor	abolitionist,propagandist,mystery_writer,novelist,satirist,screenwriter,speechwriter
Spartacus	entertainer,mercenary,bodyguard,bouncer	
Mr. Bean	advertiser,coach,actress,manager,accompanist,demonstrator,interpreter	wife,interviewee,client,capitalist,shaman,model,warlord
Monsieur Hulot		
Derek Zoolander		
Dr. Strangelove	king,musician,star,wife,god,queen,jester	judge,player,girl,student
E.T.		
Dr. Evil	medium,predator,parasite,failure,host,double_agent,prodigy	regulator,terrorist,waiter,stakeholder,lobbyist,beneficiary,hotelier
Scott Evil		
Bane		
Naomi Campbell	candidate,employer,lawyer,farmer,girl,lady,supporter	client,pupil,capitalist,detainee,professional,model,warlord
Sarah Jessica Parker	woman,beauty,hunter,predator,backer,puppet,assassin	referee,competitor,expert,proposer,entrepreneur,controller,judge
Kevin Bacon	boy,investigator,consul,nanny,aristocrat,groupie,imitator	nationalist,caller,propagandist,abolitionist,novelist,screenwriter,satirist
Hans Gruber	liberator,deputy,miracle_worker,colonist,authority,citizen,leader	pupil,capitalist,mother,functionary,model,warlord,sinner
Antonio Salieri	impersonator,demon,critic,admirer,peer,traveler,golfer	target,rival,believer,follower,client,lover,senior
Saruman the White	wizard,recruit,butcher,bitch,footballer,nerd,nanny	appellant,examiner,recruiter,beneficiary,boxer,lender,chemist
Gandalf the Grey	hit_man,pope,knight,commoner,satrap,lord,surgeon	insurgent,terrorist,brown_nose,colonist,lieutenant,abbot,underling
Sauron		
Maleficent		
Norman Bates	monster,rival,backer,foe,follower,tormentor,supporter	client,pupil,mother,professional,senior,rescuer,representative
Nigel Tufnel	gatekeeper,plastic_surgeon,helper,pawn,rapper,guitarist,storyteller	manipulator,cheater,broadcaster,suitor,jockey,troublemaker,principal
Judge Joe Dredd		
Wesley Crusher	applicant,advocate,authority,prodigy,dancer,editor,saint	teacher
Sarah Silverman	adolescent,actress,general,school_kid,master,fashion_model,footballer	king,star,wife,musician,jester,student,judge
Tweety Pie	performer,star,authority,player,manager,fashion_model,girl	wife,celebrity,tour_guide,soldier,model,role_model,guide
Sylvester the Cat	coach,guest,con_man,doctor,counsellor,homeowner,sibling	beauty,wife,driver,student,professional,model,lady
Ronald McDonald		
The HamBurglar		
Osama Bin Laden	liar,goon,predator,villain,assailant,intruder,tyrant	actress,screenwriter,messiah,comedian,novelist,evil_genius,inventor
Saddam Hussein	hit_man,debtor,woman,father,suspect,child,bomber	housekeeper,mouthpiece,bouncer,lieutenant,cheater,incumbent,discussant
Ayatollah Khomeini	con_man,doctor,sage,commoner,tyrant,aristocrat,deity	explorer,promoter,failure,controller,iconoclast,architect,experimenter
Leonardo DiCaprio		
Jay Gatsby		
Michael J. Fox	hit_man,liar,colonizer,villain,fan,chronicler,sinner	pimp,mercenary,bouncer,dissident,captive,punter,butcher
Ellen Ripley	executioner,spy,chess_player,pontiff,con_man,passenger,miracle_worker	detective,socialist,defendant,mother,torturer,daddy,husband
Clarice Starling		
Scarlett O'Hara	advertiser,coach,con_man,visitor,actress,manager,accompanist	builder,applicant,travel_agent,client,mother,professional,model
Modesty Blaise	coach,visitor,consul,sage,manager,aristocrat,interpreter	ghost,singer,driver,peasant,client,fielder,prostitute
Sarah Connor	gatekeeper,plastic_surgeon,helper,pawn,rapper,guitarist,storyteller	manipulator,cheater,broadcaster,suitor,jockey,troublemaker,principal
Condoleezza Rice	vet,woman,consul,debtor,commoner,aristocrat,lord	ghost,cleric,guitarist,tour_guide,invalid,mercenary,oracle
Donald Rumsfeld	gang_lord,kidnapper,car_dealer,soldier,witch,nanny,lawyer	insurgent,colonist,lieutenant,abbot,emperor,rescuer,underling
Lisbeth Salander		
Princess Leia Organa		
Hermione Granger	lender,confidante,retailer,seller,spokesman,swain,editor	beauty,celebrity,mercenary,witch,chronicler,communist,boarder
Sydney Bristow	detective,cop,doctor,visitor,homeowner,manager,underwriter	infidel,double,actress,nun,villain,pupil,professional
Dana Scully	gatekeeper,coach,devotee,aristocrat,manager,baby,golfer	fighter,wife,tour_guide,mercenary,pupil,oracle,minister
Marie Curie	hit_man,decision_maker,father,fan,lawyer,baby,nurse	diplomat,exporter,supervisor,abbot,star,spouse,rescuer
Tim Burton	devotee,theorist,con_man,visitor,sage,deity,supporter	singer,builder,travel_agent,representative,mother,model,marketer
Coco Chanel	chef,groom,guru,beginner,homeowner	
Fox Mulder	gatekeeper,coach,devotee,aristocrat,manager,baby,golfer	fighter,wife,tour_guide,mercenary,pupil,oracle,minister
Bruce Willis	Catholic,giant,liar,pope,queen,aristocrat,scoundrel	ghost,convert,medium,goddess,source,speaker,oracle
Robert Downey Jr.		
Michael Schumacher	nominee,predator,villain,iconoclast,intruder,demonstrator,evil_genius	chauffeur,jockey,suicide_bomber,minister,bomber,rescuer,dispatcher
Oscar Pistorius		
Bernard Madoff		
Julian Assange		
Tom Ripley	attorney,reporter,celebrity,source,suitor,supporter,witness	fighter,brown_nose,mother,bureaucrat,mercenary,detainee,prisoner
Mrs. Doubtfire		
Kim Jong-Il	liberal,monster,doctor,failure,snob,inferior	
Kim Jung-un		
Simon Pegg	con_man,candidate,visitor,leader,manager,lady,supporter	giant,celebrity,tour_guide,fan,professional,senior,guide
Anne Boleyn		
King Henry VIII		
Angela Merkel	voter,con_man,father,manager,communist,supporter,operative	cleric,house_guest,constable,litigator,incumbent,functionary,senior
Silvio Berlusconi	gatekeeper,coach,liar,devotee,wizard,father,baby	diplomat,groom,tour_guide,poacher,spouse,rescuer,dealer
Princess Fiona	executioner,spy,chess_player,pontiff,con_man,passenger,miracle_worker	detective,socialist,defendant,mother,torturer,daddy,husband
Victor Frankenstein	fashion_designer,coach,con_man,researcher,father,dissident,peer	source,client,architect,mother,model,husband,anthropologist
Count Dracula	hit_man,con_man,beauty,assistant,character,controller,model	dove
Jim Carrey	fashion_designer,Catholic,liar,pawn,visitor,victim,aristocrat	driver,actor,client,pupil,student,mother,model
General George Patton	paymaster,con_man,mediator,content_provider,guard,school_kid,staffer	failure,rival,recruit,bride,subordinate,model,role_model
John F. Kennedy	kidnapper,liar,reporter,evacuee,votary,witch,victimizer	recruiter,retailer,tour_guide,beneficiary,banker,junior,chemist
Nicolas Sarkozy	advertiser,coach,guest,con_man,cop,visitor,ambassador	singer,doctor,client,pupil,professional,model,minister
Dominique Strauss-Kahn	deputy,populist,entertainer,scammer,tyrant,despot,aristocrat	caller,propagandist,representative,pupil,screenwriter,speechwriter,satirist
Alexander the Great	king,vendor,pawn,pope,queen,lord,leader	singer,athlete,driver,actor,general,bull,supporter
Pocahontas	fashion_designer,performer,chess_player,con_man,gentleman,newborn,peer	client,mentor,mother,model,role_model,guide,husband
Amelia Earhart	liar,con_man,hijacker,homeowner,freedom_fighter,traitor,prince	builder,tour_guide,chief,client,mother,professional,model
Charles Lindbergh	liar,con_man,hijacker,homeowner,freedom_fighter,traitor,prince	builder,tour_guide,chief,client,mother,professional,model
Frida Kahlo	advertiser,infant,coach,con_man,visitor,actress,manager	applicant,travel_agent,client,capitalist,mother,professional,model
Judy Garland	Catholic,infant,wizard,queen,housewife,tyrant,caregiver	tutor,client,artisan,professional,lady,marketer,pupil
Ella Fitzgerald	advertiser,coach,con_man,visitor,actress,manager,accompanist	diviner,politician,doctor,driver,speaker,pupil,president
Sylvia Plath	ambassador,coach,researcher,publicist,authority,preacher,critic	publisher,spokesperson,prophet,priest,chronicler,judge,anthropologist
Nicolas Cage	tourist,housewife,employer,manager,actress,buyer,supporter	vet,manipulator,censor,mercenary,travel_agent,sinner,prostitute
Malcolm X	bully,nominee,sadist,witch,intruder,despot,assassin	attorney,retailer,seller,regulator,broadcaster,banker,wholesaler
Rosa Parks	abbess,pope,geisha,ayatollah,votary,savior,martyr	fighter,wife,tour_guide,mercenary,pupil,oracle,minister
Sean Penn	candidate,helper,housewife,babysitter,traitor,tyrant,farmer	convert,gang_member,slaveholder,mercenary,student,prisoner,subordinate
Mickey Rourke	fashion_designer,giant,queen,freedom_fighter,demonstrator,aristocrat,interpreter	doctor,client,capitalist,mother,professional,senior,marketer
Elton John	monster,gentleman,newborn,sacred_cow,knave,deity,dove	diner,source,failure,editor,fashion_model,model,role_model
Bradley Manning	pope,knight,wizard,commoner,satrap,lord,golfer	bodyguard,pimp,housekeeper,demon,proposer,oracle,porter
Chelsea Manning	pope,knight,wizard,commoner,satrap,lord,golfer	bodyguard,pimp,housekeeper,demon,proposer,oracle,porter
Tim Berners-Lee	duke,pope,pawn,bull,psycho,golfer,evil_genius	crony,fundamentalist,insurer,atheist,recruiter,junior,chemist
Edward Snowden		
Sergey Brin	fashion_designer,ambassador,coach,con_man,visitor,victim,supporter	singer,wife,author,minister,capitalist,mother,president
Larry Page	gatekeeper,coach,devotee,aristocrat,manager,voter,baby	passenger,juvenile,pupil,citizen,peer,troublemaker,junior
Montgomery Burns	liar,pope,gang_lord,knight,commoner,bull,lord	terrorist,ruler,saint,god,interpreter,caregiver,speechwriter
Waylon Smithers		
Mayor Joe Quimby		
Chief Clarence Wiggum	detective,Catholic,coach,con_man,ambassador,consul,queen	client,pupil,capitalist,detainee,professional,senior,warlord
Lionel Hutz	detective,fashion_designer,coach,con_man,doctor,visitor,pastor	broadcaster,pupil,capitalist,mother,professional,senior,representative
Troy McClure	vet,manipulator,censor,vocalist	
Rainier Luftwaffe Wolfcastle		
Krusty the Clown	insider,journalist,passenger	
Edna Krabappel		
Kent Brockman		
Hans Moleman		
Selma Bouvier		
Principal Seymour Skinner	gatekeeper,coach,underdog,nominee,foreigner,oppressor,conqueror	pimp,housekeeper,demon,teenager,renter,prostitute,opponent
Nelson Muntz	terrorist,monster,rival,backer,companion,critic,peer	follower,foe,host,admirer,tormentor,supporter
Groundskeeper Willie MacDougal		
Thomas "Neo" Anderson	pope,pawn,traitor,oligarch,tyrant,despot,communist	evangelist,insurer,spokesperson,dissident,boxer,bailiff,junior
Morpheus	Catholic,convert,liberal,impersonator,wizard,demon,believer	king,climber
Trinity	hit_man,woman,con_man,celebrity,predator,snake,lady	applicant,tour_guide,travel_agent,client,representative,professional,model
Agent Smith		
Glenn Quagmire		
Uri Geller	spokesman,confidante,retailer,seller,lender,swain,editor	ghost,target,wife,celebrity,regulator,mentor,mother
Jeffrey "The Dude" Lebowski		
Iggy Pop	advertiser,theorist,devotee,visitor,accompanist,interpreter,deity	constable,mercenary,travel_agent,capitalist,mother,professional,sinner
Mark Zuckerberg		
Roy Batty		
Rick Deckard	minion,beast,demon,thrall,monster	
Dr. Eldon Tyrell	fashion_designer,ambassador,coach,doctor,visitor,groom,judge	client,fan,pupil,mother,oracle,senior,representative
Thor Odinson		
Loki Laufeyson		
Richard B. Riddick	medium	
Alan Turing	detective,fashion_designer,researcher,radical,benefactor,authority,depositor	adviser,theologian,assistant,historian,tutor,spiritualist,inventor
Conan the Barbarian	advertiser,coach,con_man,visitor,manager,supporter,principal	fighter,doctor,tour_guide,client,pupil,professional,model
Red Sonja	chaser,valet	
Jeff "Comic Book Guy" Albertson	Catholic,liar,con_man,visitor,victim,aristocrat,supporter	king,star,wife,musician,jester,player,student
King Richard III	liar,ruler,fugitive,militant,rebel,dissenter,aristocrat	ghost,nominee,demon,beast,captive,intruder,widow
Queen Elizabeth I		
Dr. Henry Jekyll	chef,groom,guru,beginner,homeowner	
Mr. Edward Hyde	gatekeeper,coach,devotee,vassal,wizard,underwriter,golfer	diplomat,star,cleric,general,pupil,spouse,minister
Travis Bickle		
Tyler Durden		
Sam Winchester	musician,monster,caller,propagandist,exporter,abolitionist,speechwriter	travel_agent,client,pupil,mother,professional,senior,rescuer
Dean Winchester	musician,monster,caller,propagandist,exporter,abolitionist,speechwriter	travel_agent,client,pupil,mother,professional,senior,rescuer
Jesus Christ	liar,knight,commoner,junior,bull,creditor,marketer	landowner,lessee,beneficiary,controller,handler,borrower,mother
Lucifer	confessor,sage,lion,deity,martyr,prince,witness	ghost,target,wife,fan,pupil,baby,model
Eric Cartman		
Agent Phil Coulson		
Nick Fury	cartographer,reporter,prophet,seller,activist,commentator,manufacturer	exporter,slave,pawn,helper,guard,manipulator,puppet
Russell Brand	advertiser,devotee,guitarist,actress,accompanist,buyer,interpreter	singer,bowler,doctor,commissioner,imitator,mother,representative
Jeremy Paxman	gatekeeper,coach,devotee,aristocrat,manager,baby,golfer	medium,source,tour_guide,failure,mimic,fashion_model,leader
Boris Johnson	fashion_designer,advertiser,respondent,student,ambassador,propagandist,demonstrator	attorney,star,censor,fan,teenager,entertainer,anthropologist
Ebenezer Scrooge	renter,tyrant,parasite	
Wilkins Micawber		
Fagin		
The Artful Dodger		
Uriah Heap		
Bob Cratchit	detective,juvenile,lessee,bailiff,proposer,friar,peon	harasser,policyholder,intruder,incumbent
Tiny Tim Cratchit	detective,juvenile,lessee,bailiff,proposer,friar,peon	harasser,policyholder,intruder,incumbent
Jean-Paul Sartre		
Simone de Beauvoir		
Monica Lewinsky	Catholic,coach,con_man,ambassador,visitor,counsellor,doctor	debtor,gang_member,mercenary,student,prisoner,persecutor,mastermind
Colonel Kurtz	liar,pope,knight,chef,villain,surgeon,martyr	medium,censor,tour_guide,vocalist,manipulator,dealer,satirist
Jor El	diner,child	
Kal El	diner,child	
General Zod		
Bridget Jones	detective,cop,coach,con_man,doctor,visitor,homeowner	translator,infidel,builder,actress,nun,villain,friend
Lizzy Bennet		
Mr. Darcy	gatekeeper,vet,voter,devotee,aristocrat,baby,golfer	duke,terrorist,liberal,inferior,snob,emperor,whore
John Constantine	cleric,coach,con_man,sage,commoner,seducer,caregiver	customer,competitor,suicide_bomber,seller,reader,witness,opponent
Hellboy	giant,con_man,demon,lion,school_kid,bomber,supporter	king,bowler,candidate,wife,student,judge,native
Charlie Harper	gatekeeper,plastic_surgeon,helper,pawn,rapper,guitarist,storyteller	manipulator,cheater,broadcaster,suitor,jockey,troublemaker,principal
Snake Plissken	enemy,coach,liar,con_man,necromancer,colonist,buyer	executioner,spinster,pontiff,hostage,crooked_cop,villain,interrogator
Severus Snape	coach,doctor,visitor,consul,sage,manager,aristocrat	author,tour_guide,travel_agent,pupil,professional,model,minister
Borat		
Ali G	trainer,boy,hero,decision_maker,double_agent,adult,entertainer	respondent,lessee,stakeholder,beneficiary,mother,spouse,defendant
Jack Reacher	attorney,coach,chess_player,content_provider,authority,lawyer,judge	artist,gang_member,priest,mentor,model,instructor,role_model
Arthur Dent	advertiser,coach,con_man,visitor,actress,manager,accompanist	emissary,brown_nose,sucker,lobbyist,valet,proxy,martyr
Del Boy Trotter	advertiser,coach,con_man,visitor,actress,manager,accompanist	customer,fighter,target,driver,regulator,wholesaler,criminal
Captain William Bligh		
Fletcher Christian	liberator,coach,liar,con_man,necromancer,colonist,judge	subscriber,handler,shareholder,babysitter,navigator,hoodlum,bitch
